%%%%%%%%%%%%%%%%%%%%%%%%%
%    .   .  ..... ..... %
%..P..   .  .   . .     %
%  . .   .  .   . .     %
% ...... .  ..... .....G%
%    .   .  .   .     . %
%    .   .  .   .     . %
%    .   .  ..... .....o%
%%%%%%%%%%%%%%%%%%%%%%%%%
