+-+-+-+-+-+-+-+-+-+-+
| | |       |       |
+ + +-+-+-+ + +-+ + +
|   |     |   |   | |
+ +-+ +-+ + +-+-+-+ +
| | | |   |       | |
+ + +-+-+ + +-+-+-+-+
|     | |           |
+-+-+ + +-+ +-+ + +-+
|     | | |   | |   |
+-+ +-+ + + +-+-+ +-+
| |   | |   |   |   |
+ + +-+ + +-+ +-+-+-+
|         | |   | | |
+-+ + +-+ + + +-+ + +
| | | |           | |
+ + +-+-+ +-+ + +-+ +
|       | | | | | | |
+-+ +-+ +-+ + +-+ + +
|     |     |       |
+-+-+-+-+-+-+-+-+-+-+