#################################################
# .  #.        #             #  .#     # #   #  #
#    #### ###### #  # # ##         ####  #. ### #
#    #.#    # .# #  # #  #   #   #          #   #
#   .            #.     #### #   ## .### #      #
# ##### ######  #### #           .#    #. #######
#.      #   .#       .# ###  ######  # #  #   # #
### ##  # ####### ##### #    #  . ## # #    #.# #
#    #  #      #  #      T# ##       #   #### # #
#.      #   #  #  #     #          #       .#   #
# # ###   .# #    ## ## ### ## #  #.########### #
#   #    #    #              #    #             #
#################################################
