####################################
#                                 T#
# ################### ### ######## #
# ##   #   #      ### ###   ## ... #
# ## # # # # #### ######### ## #####
# ## # # # # #    ##     ## ## ... #
# ## # # # # # ####  ###    ###### #
# #  # # #   #    ## ########  ... # 
# ## # # ######## ##        ## #####
# ## #   ##       ######### ## ... #
#    ###### #######      ## ###### #
######      #       #### ## #  ... #
#      ###### ##### #    ## ## #####
# ######      #       ##### ##     #
#        ###### ########### ##  ## #
##########                  ###### #
#.         ################ ...... #
####################################