####################
#.           ...T .#
#.##.##.##.##.## #.#
# ## #.....      #.#
####################
