#########
#..   ..#
####.## #
#   T   #
#.## ##.#
#.#.   .#
#########
