######
#....#
# ##.#
# ##.#
#.T .#
#.####
#....#
######