##############################
#.      # # #              #.#
#       # # ###### ####### # #
#       #        #     # #   #
##### ##### ### ## ##### # ###
#   # # # #   #    #     #   #
# ### # # # ######## ### ### #
#       #     ##     # # #   #
### # ####### #### ### # # # #
# #           ##     #     # #
# # ##### # #### # ### ### # #
#   #     #      # #   # ### #
#.  #T#####      # ### #    .#
##############################