########
#.    .#
#   T  #
# #### #
# #    #
# # ####
#.#   .#
########
