####################################
#                                 T#
# ####################### ##########
# ##   #   #      #######   ########
# ## # # # # #### ######### ########
# ## # # # #             ## ########
# ## # # # # # ####  ###    ########
# #  # # #   #    ## ###############
# ## # # ######## ##        ########
# ## #   ##       ######### ########
#    ###### #######      ## ########
######      #       #### ## ########
#      ###### ##### #    ## ########
# ######      #       ##### ########
#        ###### ########### ########
##########                  ########
#.         #########################
####################################