#######
#    T#
# ### #
#  #  #
##   ##
#. ####
#######
