+-+-+-+-+-+-+-+-+-+-+
|       | | | | |   |
+-+-+-+ + + + + + + +
|   | |   |       | |
+ +-+ + +-+-+ + + + +
|   | |       | | | |
+ +-+ +-+-+ + +-+-+-+
|     | |   | | | | |
+ +-+ + + + + + + + +
| |   | | | | | |   |
+-+ +-+ + + + + + +-+
| | |     | |   | | |
+ + + +-+-+-+ +-+ + +
| |         |   |   |
+ + +-+ +-+ + +-+ +-+
| | | | |   | | |   |
+ +-+ + +-+ +-+ + + +
| |     |     | | | |
+ +-+-+-+-+-+ + +-+ +
|                   |
+-+-+-+-+-+-+-+-+-+-+
